NO ./textures/wall_1.xpm
SO ./textures/wall_2.xpm
WE ./textures/wall_3.xpm
EA ./textures/wall_4.xp=






F 220,100,0
C 10,125,200





        11111 111111111 111111111
        10001 1000110001000000001
        110011001110000000000011
        1000000000000000000000001
111111111011000001110000000000001
100000000011000001110111111111111
11110111111111011100000010001
   10111111111011101010000001       1111111
1110000011010101110000000000111111111000001
100000000000000011000000100000000000000W001
1000000000000000110000001000111111111000001
10000000000000001101010010001       1111111
1100100111010101111101111000111
1111 111 1110101 101111010001
1111 111 1111111 111111111111