NO ./textures/wall.xpm
SO ./textures/wall.xpm
WE ./textures/wall.xpm
EA ./textures/wall.xpm

F 220,100,0
C 254,30,0

        11111 111111111 111111111
        10001 1000110001000000001
        1010010001110000000000011
        1000000000000000000000001
111111111011000001110000000000001
100000000011000001110111111111111
11110111111111011100000010001
   10111111111011101010000001       1111111
11100000110101011100000000001       1000001
10000000000000001100000010001       1000001
10000000000000001101010010001       1111111
11001001110101011111011110N0111
1111 111 1110101 101111010001
1111 111 1111111 111111111111